	6	7	3	8	G	1
	8	5	2	8	9	3
	6	4	7	7	8	9
	5	3	6	4	4	2
	S	5	4	3	6	7