6	G	7	6	2	7
5	5	7	4	5	6
9	9	7	2	8	8
5	7	5	8	7	6
4	7	2	7	S	3